21 11
11111111111
20000000101
10111111101
10000010101
10101110101
10100010001
11101010111
10001000101
10111011101
10100000101
11111011101
10000000101
11111010101
10001010001
11101011111
10001000001
11101110111
10100000101
10111110101
10000000003
11111111111
