21 21
111111111111111111111
200010100000100000001
111010101111111110111
100010000000000000001
101011101111111111111
101010001000000000001
101011101110111011111
101000100010101010001
101010101011101010111
101010001010101010001
101110111010101010111
101000101010101010101
101110101110101010101
100010000010000000001
111011101111111010101
101000101000000010101
101010101011111010101
100010100010100010101
101110101010111110101
101000101000000010103
111111111111111111111
