21 21
111111111111111111111
200000001000000000101
111111101011111110101
100010001000001010001
101110111111101011101
101010001000101010101
101011101110101010111
100000000010000000001
111110111011101110111
100000100010001000001
111011101010111111101
100000101000000000101
101111101010111011101
100000101010100010101
101011111111111010101
101010001010000000101
101110101011111011111
101000101010000000101
101011111010111110101
100000001000000010003
111111111111111111111
